Bal_stormiae	CCGAAT	CTAACG
Cos_macrocarpa	TTAGGCA	CTAACG
Cos_matudae	AACTCGTC	CTAACG
Cos_valerii	GGTCTACGT	CTAACG
Ham_patens	GATACC	CTAACG
Hil_bonoi	AGCGTTG	CTAACG
Hil_macbridei	CTGCAACT	CTAACG
Hil_macromeris	TCATGGTCA	CTAACG
Hil_macrophylla1	CCGAAT	TCGGTAC
Hil_macrophylla2	TTAGGCA	TCGGTAC
Hil_macrophylla3	AACTCGTC	TCGGTAC
Hil_parasitica1	GGTCTACGT	TCGGTAC
Hil_parasitica2	GATACC	TCGGTAC
Hil_parasitica3	AGCGTTG	TCGGTAC
Hil_parasitica4	CTGCAACT	TCGGTAC
Hil_parasitica5	TCATGGTCA	TCGGTAC
Hil_parasitica6	CCGAAT	GATCGTTG
Hil_parasitica7	TTAGGCA	GATCGTTG
Hil_parasitica8	AACTCGTC	GATCGTTG
Hil_pumila1	GGTCTACGT	GATCGTTG
Hil_pumila2	GATACC	GATCGTTG
Hil_pumila3	AGCGTTG	GATCGTTG
Hil_wurdackii1	CTGCAACT	GATCGTTG
Hil_wurdackii2	TCATGGTCA	GATCGTTG
