EC01_US_AZVV_Fo_perp	CCGAATG	AGCTACACTT
EC04_US_AZVV_Po_mar/occ	TTAGGCAG	AGCTACACTT
EC05_US_AZMG_Fo_gnav	AACTCGTCG	AGCTACACTT
EC07_MX_SOSJSD_Ph_rhea	GGTCTACGTG	AGCTACACTT
EC11_MX_SOSE_Fo_gnav	GATACCG	AGCTACACTT
EC15_MX_SOSJRZ_Ph_rhea	AGCGTTGG	AGCTACACTT
EC16_MX_SOSE_Ph_obtu	CTGCAACTG	AGCTACACTT
EC18_US_AZPC_Ph_obtu	TCATGGTCAG	AGCTACACTT
EC19_US_AZPC_Tr_ariz	CCGAATG	ACGCATT
EC20_MX_SOSJRSF_Ph_rhea	TTAGGCAG	ACGCATT
EC21_MX_SOSJRZ_La_sp	AACTCGTCG	ACGCATT
EC24_US_AZCH_Cr_C	GGTCTACGTG	ACGCATT
EC32_US_AZCP_Li_apic	GATACCG	ACGCATT
EC33_US_AZPAY_Li_apic	AGCGTTGG	ACGCATT
EC35_US_AZPAY_Ca_vici	CTGCAACTG	ACGCATT
EC36_US_AZPC_Ca_ocre	TCATGGTCAG	ACGCATT
EC58_US_AZPC_Ph_hyat_bi	CCGAATG	GTATGCAT
EC66_US_AZPC_Ca_sans	TTAGGCAG	GTATGCAT
EC69_US_MABF_Ca_penn	AACTCGTCG	GTATGCAT
EC91_US_AZPC_Ca_sans	GGTCTACGTG	GTATGCAT
EC107_US_AZCBP_La_sp	GATACCG	GTATGCAT
EC111_US_AZCP_Cr_C	AGCGTTGG	GTATGCAT
EC113_US_AZCP_Cr_C	CTGCAACTG	GTATGCAT
EC114_US_AZCP_Li_apic	TCATGGTCAG	GTATGCAT
