EC01_US_AZVV_Fo_perp	CCGAAT	AGCTACACT
EC04_US_AZVV_Po_mar/occ	TTAGGCA	AGCTACACT
EC05_US_AZMG_Fo_gnav	AACTCGTC	AGCTACACT
EC07_MX_SOSJSD_Ph_rhea	GGTCTACGT	AGCTACACT
EC11_MX_SOSE_Fo_gnav	GATACC	AGCTACACT
EC15_MX_SOSJRZ_Ph_rhea	AGCGTTG	AGCTACACT
EC16_MX_SOSE_Ph_obtu	CTGCAACT	AGCTACACT
EC18_US_AZPC_Ph_obtu	TCATGGTCA	AGCTACACT
EC19_US_AZPC_Tr_ariz	CCGAAT	ACGCAT
EC20_MX_SOSJRSF_Ph_rhea	TTAGGCA	ACGCAT
EC21_MX_SOSJRZ_La_sp	AACTCGTC	ACGCAT
EC24_US_AZCH_Cr_C	GGTCTACGT	ACGCAT
EC32_US_AZCP_Li_apic	GATACC	ACGCAT
EC33_US_AZPAY_Li_apic	AGCGTTG	ACGCAT
EC35_US_AZPAY_Ca_vici	CTGCAACT	ACGCAT
EC36_US_AZPC_Ca_ocre	TCATGGTCA	ACGCAT
EC58_US_AZPC_Ph_hyat_bi	CCGAAT	GTATGCA
EC66_US_AZPC_Ca_sans	TTAGGCA	GTATGCA
EC69_US_MABF_Ca_penn	AACTCGTC	GTATGCA
EC91_US_AZPC_Ca_sans	GGTCTACGT	GTATGCA
EC107_US_AZCBP_La_sp	GATACC	GTATGCA
EC111_US_AZCP_Cr_C	AGCGTTG	GTATGCA
EC113_US_AZCP_Cr_C	CTGCAACT	GTATGCA
EC114_US_AZCP_Li_apic	TCATGGTCA	GTATGCA
