Bal_stormiae	CCGAATAT	CTAACGC
Cos_macrocarpa	TTAGGCAAT	CTAACGC
Cos_matudae	AACTCGTCAT	CTAACGC
Cos_valerii	GGTCTACGTAT	CTAACGC
Ham_patens	GATACCAT	CTAACGC
Hil_bonoi	AGCGTTGAT	CTAACGC
Hil_macbridei	CTGCAACTAT	CTAACGC
Hil_macromeris	TCATGGTCAAT	CTAACGC
Hil_macrophylla1	CCGAATAT	TCGGTACC
Hil_macrophylla2	TTAGGCAAT	TCGGTACC
Hil_macrophylla3	AACTCGTCAT	TCGGTACC
Hil_parasitica1	GGTCTACGTAT	TCGGTACC
Hil_parasitica2	GATACCAT	TCGGTACC
Hil_parasitica3	AGCGTTGAT	TCGGTACC
Hil_parasitica4	CTGCAACTAT	TCGGTACC
Hil_parasitica5	TCATGGTCAAT	TCGGTACC
Hil_parasitica6	CCGAATAT	GATCGTTGC
Hil_parasitica7	TTAGGCAAT	GATCGTTGC
Hil_parasitica8	AACTCGTCAT	GATCGTTGC
Hil_pumila1	GGTCTACGTAT	GATCGTTGC
Hil_pumila2	GATACCAT	GATCGTTGC
Hil_pumila3	AGCGTTGAT	GATCGTTGC
Hil_wurdackii1	CTGCAACTAT	GATCGTTGC
Hil_wurdackii2	TCATGGTCAAT	GATCGTTGC
