BYC8	CCGAATAT	AGCTACACTC
BYC2	TTAGGCAAT	AGCTACACTC
LAC2	AACTCGTCAT	AGCTACACTC
LGC2	GGTCTACGTAT	AGCTACACTC
LAC3	GATACCAT	AGCTACACTC
CMC3	AGCGTTGAT	AGCTACACTC
LAC4	CTGCAACTAT	AGCTACACTC
SAC6	TCATGGTCAAT	AGCTACACTC
LGC5	CCGAATAT	ACGCATC
DKC5	TTAGGCAAT	ACGCATC
ODC6	AACTCGTCAT	ACGCATC
DKC6	GGTCTACGTAT	ACGCATC
DKC7	GATACCAT	ACGCATC
BYC9	AGCGTTGAT	ACGCATC
LGC8	CTGCAACTAT	ACGCATC
KDC9	TCATGGTCAAT	ACGCATC
CMC8	CCGAATAT	GTATGCAC
ODC10	TTAGGCAAT	GTATGCAC
KDC11	AACTCGTCAT	GTATGCAC
CMC11	GGTCTACGTAT	GTATGCAC
SAC17	GATACCAT	GTATGCAC
ODC16	AGCGTTGAT	GTATGCAC
ODC14	CTGCAACTAT	GTATGCAC
SAC16	TCATGGTCAAT	GTATGCAC
