BYC8	CCGAAT	AGCTACACT
BYC2	TTAGGCA	AGCTACACT
LAC2	AACTCGTC	AGCTACACT
LGC2	GGTCTACGT	AGCTACACT
LAC3	GATACC	AGCTACACT
CMC3	AGCGTTG	AGCTACACT
LAC4	CTGCAACT	AGCTACACT
SAC6	TCATGGTCA	AGCTACACT
LGC5	CCGAAT	ACGCGT
DKC5	TTAGGCA	ACGCGT
ODC6	AACTCGTC	ACGCGT
DKC6	GGTCTACGT	ACGCGT
DKC7	GATACC	ACGCGT
BYC9	AGCGTTG	ACGCGT
LGC8	CTGCAACT	ACGCGT
KDC9	TCATGGTCA	ACGCGT
CMC8	CCGAAT	GTATGCA
ODC10	TTAGGCA	GTATGCA
KDC11	AACTCGTC	GTATGCA
CMC11	GGTCTACGT	GTATGCA
SAC17	GATACC	GTATGCA
ODC16	AGCGTTG	GTATGCA
ODC14	CTGCAACT	GTATGCA
SAC16	TCATGGTCA	GTATGCA
